39
22
20 20 20 20 20 20 20 20 20 20 20 20 20 20 20 20 20 20 20 20 20 20 20 20 20 20 20 20 20 20 20 20 20 20 20 20 20 20 20 
20  0  0  0  0  0  0  0  0  0  0  0  0  0  0  0  0  0  0  0  0  0  0  0  0  7  7  0  0  0  0  0  0  0  0  0  0  0 20
20  0  0  0  0  0  0  0  0  0  0  0  0  0  0  0  0  0  0  0  0  0  0  0  0  0  0  0  0  0  0  0  0  0  0  0  0  0 20
20  0  0  0  0  0  0  0  0  0  0  0  0  0  0  0  0  0  0  0  0  0  0  0  0  0  0  0  0  0  0  0  0  0  0  0  0  0 20
20  7  7  7  7  7  7  0  0  0  0  0  0  0  0  0  0  0  0  0  0  0  0  0  0  0  0  0  0  0  0  0  0  0  0  0  0  0 20
20  0  0  0  0  0  0  7  0  0  0  0  0  0  0  0  0  0  0  0  0  0  0  0  0  0  0  0  0  0  0  0  0  0  0  0  0  0 20
20  0  0  0  0  0  0  0  7  0  0  0  0  0  0  0  0 15 15 15  0  0  0  0  0  0  0  0  0  0  0  0  0  0  0  0  0  0 20
20  0  0  0  0  0  0  0  0  7  0  0  0  0  0  0  0 15 18 15  0  0  0  0  0  0  0  0  0  0  0  0  0  0  0  0  0  0 20
20  0  0  0  0  0  0  0  0  7  0  0  0  0  0  0  0 15 15 15  0  0  0  0  0  0  0  0  0  0  0  0  0  0  0  0  0  0 20
20  0  0  0  0  0  0  0  0  0  0  0  0  0  0  0  0  0  0  0  0  0  0  0  0  0  0  0  0  0  0  0  0  0  0  0  0  0 20
20  0  0  0  0  0  0  0  0  0  0  0  0  0  0  0  0  0  0  0  0  0  0  0  0  0  0  0  0  0  0 15 15 15 15  0  0  0 20
20  0  0  0  0  0  0  0  0  0  0  0  0  0  0  0  0  0  0  0  0  0  0  0  0  0  0  0  0  0  0 15 18 18 15  0  0  0 20
20  0  0  0  0  0  0  0  0  0  0  0  0  0  0  0  0  0  0  0  0  0  0  0  0  0  0  0  0  0  0 15 18 18 15  0  0  0 20
20  0  0  0  0  0  0  0  0  7  0  0  0  0  0  0  0 15 15 15  0  0  0  0  0  0  0  0  0  0  0 15 15 15 15  0  0  0 20
20  0  0  0  0  0  0  0  0  7  0  0  0  0  0  0  0 15 18 15  0  0  0  0  0  0  0  0  0  0  0  0  0  0  0  0  0  0 20
20  0  0  0  0  0  0  0  7  0  0  0  0  0  0  0  0 15 15 15  0  0  0  0  0  0  0  0  0  0  0  0  0  0  0  0  0  0 20
20  0  0  0  0  0  0  7  0  0  0  0  0  0  0  0  0  0  0  0  0  0  0  0  0  0  0  0  0  0  0  0  0  0  0  0  0  0 20
20  7  7  7  7  7  7  0  0  0  0  0  0  0  0  0  0  0  0  0  0  0  0  0  0  0  0  0  0  0  0  0  0  0  0  0  0  0 20
20  0  0  0  0  0  0  0  0  0  0  0  0  0  0  0  0  0  0  0  0  0  0  0  0  0  0  0  0  0  0  0  0  0  0  0  0  0 20
20  0  0  0  0  0  0  0  0  0  0  0  0  0  0  0  0  0  0  0  0  0  0  0  0  0  0  0  0  0  0  0  0  0  0  0  0  0 20
20  0  0  0  0  0  0  0  0  0  0  0  0  0  0  0  0  0  0  0  0  0  0  0  0  7  7  0  0  0  0  0  0  0  0  0  0  0 20
20 20 20 20 20 20 20 20 20 20 20 20 20 20 20 20 20 20 20 20 20 20 20 20 20 20 20 20 20 20 20 20 20 20 20 20 20 20 20